TILEMAP
36 28 							-- Size of tile map in tiles
32 32 							-- Tile size & block size
images/sonictiles.png 					-- Tilesheet
8 12 							-- Number of tiles in tilesheet
!!!!!!!!!!!!!!!!!!!!!!!!!!!!!!!!!!!!
!!!!!!!!!!!!!!!!!!!!!!!!!!!!!!!!!!!!
!!!!!!!!!!!!!!!!!!!!!!!!!!!!!!!!!!!!
!!!!!!!!!!!!!!!!!!!!!!!!!!!!!!!!!!!!
!!!!!!!!!!!!!!!!!!!!!!!!!!!!!!!!!!!!
!!!!!!!!!!!!!!!!!!!!!!!!!!!!!!!!!!!!
11!!!!!!!!!!!1!1!1!1!1!!!!!!!!!!!!11
1111!!!##***!!!1!!!1!!!########!!!11
11!!!!!!!!!!!1!1!1!1!1!!!!!!!!!!!!11
!!!!!!!!!!!!!!!!!!!!!!!!!!!!!!!!!!!!
!!!!!!!!!!!!!!!!!!!!!!!!!!!!!!!!!!!!
!!!!!!!!!!!!!!!!!!!!!!!!!!!!!!!!!!!!
1111!!!!!!!!!!!!!!!!!!!!!!!!!!!!1111
!!!!!!!!!!J!!!!!!!!!!!!!!!!!!!!!!!!!
##########I###########**************
11              111               11
11                                11
1111   111  22       22  1111   1111
11            22   22             11
11             22222              11
11                                11
11                                11
1111   1111111111111111111111   1111
11                                11
11                                11
11                                11
11                                11
111111111111111111111111111111111111

